15 18 xxx
.D........H...D...|
.D..C..DD..H.D..P.|
...C......H....P..|
..C..S........P...|
.C.....H.H...P....|
....DD..H...P...D.|
S...............D.|
......C..S..S.....|
...S...C..........|
........C...CCCC..|
..PPPPP..C.......C|
...............H.C|
...........DD.H..C|
...S..D..H.....H.C|
.....D..H.H.......|
